Name:
Main Hall
Steps Taken:
0
Elapsed Time:
0
        ######
####### #    ##
#     ### ##  ##
# #  @o##@  #  ##
#  #  *oAo*  #  #
##  #  @##o@  # #
 ##  ## ###     #
  ##    # #######
   ######
