Name:
The Warehouse
Steps Taken:
0
Elapsed Time:
0
    #####
    #   #
    #@  #
  ###  @##
  #  @ @ #
### # ## #   ######
#   # ## #####  oo#
# @  @          *o#
##### ### #A##  oo#
    #     #########
    #######
