Name:
Crossroads
Steps Taken:
0
Elapsed Time:
0
       #####
       #   #
      ## # #
      # *  #
      # # ##
####### #  #
#   # o@o@o####
# #   @@o@@   ###
#  *##ooAoo##*  #
###   @@o@@   # #
  ####o@o@o #   #
     #  # #######
      ## # #
      #  * #
      # # ##
      #   #
      #####
